1111111111111111
1000000000000001
1000000000000001
1000000000000001
1000000000000001
1000000000000001
1000000000000001
10000000000P0001
1000000000000001
1000000000000001
10000000000E0001
10000000C0000001
1000000000000001
1000000000000001
1000000000000001
1111111111111111