1111111111111
1C010C00000C1
1000011111001
1P0011E0000C1
1111111111111